
Contract T
+----------+-----------+
| Function | Modifiers |
+----------+-----------+
| g        |        [] |
+----------+-----------+
Contract T2
+----------+-----------+
| Function | Modifiers |
+----------+-----------+
| h        |        [] |
+----------+-----------+
