
Contract T
+----------+-------------------+
| Function | require or assert |
+----------+-------------------+
| g        |                   |
+----------+-------------------+
Contract T2
+----------+-------------------+
| Function | require or assert |
+----------+-------------------+
| h        |                   |
+----------+-------------------+
